##########################
#........................#
#................#.......#
#........X.......#.......#
#................#.......#
##################...#####
#............%........%%..
#....#####################
#........................#
################.#########
